..#######################################
......#.#...#...#...#.......#.........#.#
#.###.#.###.#.###.###.#####.###.###.#.#.#
#.#...................#.#.......#.#.#.#.#
#.#########.###.#.#.#.#.#.###.#.#.#####.#
#.#.......#.....#.#.#...#.#...#.#.......#
#.#.###.###.#.#####.#######.#######.###.#
#...#.#...#.#.....#.....#.#.........#.#.#
#.#.#.###.#.###.#.#.###.#.#####.#.###.###
#.#.....#.#.#.#.#.#.#.......#.#.#.......#
###.###.#.#.###.#.###.#######.###.###.#.#
#...#.#.....#.#...#.....#.#.........#.#.#
###.#.###.#.#.###.#.###.#.###.#.#######.#
#...#...#.#...#...#.#.#.......#.#.......#
#.###.#.#.#######.###.#.####.####.#####.#
#.#...#.#.#.......#.....#.#...#.#.#.....#
#.#.#######.###.###.#.#.#.#.#.#.#######.#
#...#.#.#.#.#.#...#.#.#.....#...#.......#
#.#.#.#.#.#.#.###.#.#.#########.#.###.###
#.#.....#.....#.......#..........#.......
#######################################.F